1111111111111
1P00100000001
10C0001110101
1100001E00001
1111111111111