1111111111111111111111111
10000000000000000000000E1
1000000110000000111100001
1000CC101000000100CC10001
1000C10010000010000CC1001
100010001000CC10000001001
100111111111CC00001110001
100000001000000001C000001
10000000100000001CC000001
1000000010000001111111001
1P00000000000000000000001
1111111111111111111111111