111111
1000P1
110001
10C001
100001
111111