111111
100001
10P0011
1C00C1
10E001
111111