111111
100001
10P001
1C00C1
10E0?1
111111