

NO ./texture/north.xpm
C 200,255,255

EA ./texture/east.xpm
SO ./texture/south.xpm

WE ./texture/west.xpm




F            150,150,150




            1111111111111111111111111
            1000000000110000000000001
            1011000001110000000000001
            1001000000000000000011111
111111111111100001110000000000001
100000000011000001110111111111111
11110111111111011100000010001
11110111111111011101010010001
11000000110101011100000010001
10000000000000000000000000001
10000000000000000000000000001
10000000000000001100000010001
10000000000000001101010010N01
110000011101010111110111100111
11110111 1110101 101111010001
11111111 1111111 111111111111